data_id	编号	无	无
id	系统编码	无	无
name	姓名	无	无
sex	性别	性别:	无
courtesy_name	字	字	无
pseudonym	号	号	无
used_name	曾用名	曾用名	无
father_id	父亲编号	父亲:		无
mother_id	母亲编号	母亲:	无
partner_id	配偶编号	娶	无
shi	世	第	世
rank	辈份	辈份：	无
rank_family	家庭排行	家庭排行：	无
address	住址	居住于	无
era	朝代	无	无
birth	公历出生日期	生于	无
china_birth	农历出生日期	生于	无
death_date	公历过世日期	卒于	无
china_death	农历过世日期	卒于	无
yearsLived	享年	享年	无
grave	葬于	葬于	无
education	文化程度	无	学历
school	毕业院校	毕业于	无
work_unit	工作单位	工作于	无
occupation	职业	职业：	无
duty	职务（官职）	无	无
briefBiography	简介	无	无
originalFamily	祖籍	祖籍：	无
birthPlace	出生地	出生于	无
ethnicity	民族	无	无
posthumousTitle	谥号	谥号：	无
description	其他描述	无	无
phone	联系电话	联系电话	无
email	电子邮箱	电子邮箱	无
son_id	儿子	生子：	无
daughter_id	女儿	生女：	无
birth	出生日期	生于	无
death_date	过世日期	卒于	无
son_name	儿子姓名	生子：	无
daughter_name	女儿姓名	生女：	无